111111111111111
100000010000001
1P00000000C0001
111100000000001
100000CCCCE0001
111111111111111
