111111111111111111111111111111
11E0000C1100111011011011010001
1010111111100000110110100101C1
101000100100101001010010110101
101010101101101101000100010111
110000100000101101000001010001
110011111111100100011111011101
100110000000C10111000001000001
110000111111110000111101110011
1010101010000C1110100001011011
101010001010111100111011001011
101011110010100001110011011001
111C11000110001111000100011101
1C1010011111111P00011111010001
1010101000000010C1001000010111
100010111011101111101110110111
110110001000100000101000100111
110001100110111110001101101101
100101110010010011110000000001
111101111011000110110111111101
1101000110C1100001000101001111
100101000001101100010011100011
101101111010000011111000101011
100100C000101C111000111C111011
111111111111111111111111111111