11111
10P01
1C001
1E001
11111