11111111111111
11111110000001
11101110101011
1C1000000PE111
11100000000001
11111111111111
