11111111111111
11111110000001
11101110101011
1010000000C111
11100000000001
11111111111111
