111111
100001
100101
1010111
111111